C 153,255,255

EA ./game_assets/EA.xpm


BBBBBBBBBBBBBBBBBB
B11111111111BB111B
B10S00000001BB101B
B1000000000111101B
B1000000000000001B
B1111110111111111B
BBBBBBBBBBBBBBBBBB


1111
1001
1011
111

h 4 w 4
malloc(6 x 6)

000000
011B10
010010
010110
011100
000000

        1111111111111111111111111
        1000000000110000000000001
        1011000001110000000000001
        1001000000000000000000001
111111111011000001110000000000001
100000000011000000010111111111111
11110111111111011100000010001
11110111111111011101010010001
11000000110101011100000000001
10000000000000001100000010001
10000000000000001101010010001
1100000111010101111101111W111
11110111 1110101 101111011011
11111111 1111111 111111111111